0 0 0 0 4 0 0 0 5 0
0 0 0 0 0 0 0 0 0 0
2 0 0 5 0 0 0 0 0 0
0 0 3 0 0 0 0 0 0 0
0 1 0 0 0 0 0 0 0 0
6 6 6 6 6 6 6 6 6 6
6 6 6 6 6 6 6 6 6 6
6 6 6 6 6 6 6 6 6 6
6 6 6 6 6 6 6 6 6 6
6 6 6 6 6 6 6 6 6 6
0 0 2 0 0 0 0 0 0 0
0 0 0 0 0 0 0 0 0 2
0 0 5 0 0 0 0 0 0 0
0 0 0 0 0 0 0 5 0 0
0 0 0 3 0 0 0 0 0 0
0 2 0 0 0 0 0 4 0 0
0 1 0 0 0 0 0 0 0 0
6 6 6 6 6 6 6 6 6 6
6 6 6 6 6 6 6 6 6 6
6 6 6 6 6 6 6 6 6 6
6 6 6 6 6 6 6 6 6 6
6 6 6 6 6 6 6 6 6 6
4 0 0 0 0 2 2 0 0 0
0 0 0 0 0 0 2 0 0 0
0 0 0 0 0 0 2 0 0 0
0 0 0 0 0 0 0 0 5 0
0 5 0 1 0 0 2 0 5 0
0 0 0 0 0 0 0 0 0 0
0 0 0 0 0 0 0 0 0 0
0 2 0 0 0 0 0 0 0 0
0 0 0 0 0 0 0 4 0 0
0 1 0 0 0 0 0 4 0 0
6 6 6 6 6 6 6 6 6 6
6 6 6 6 6 6 6 6 6 6
6 6 6 6 6 6 6 6 6 6
6 6 6 6 6 6 6 6 6 6
6 6 6 6 6 6 6 6 6 6
0 0 0 0 0 0 0 0 0 0
0 0 0 0 0 0 0 0 0 2
4 0 0 0 0 0 0 0 0 0
0 0 0 0 0 0 0 0 0 0
3 0 0 3 0 0 0 0 0 2
0 0 0 0 0 5 0 4 0 0
0 1 0 0 0 0 0 0 0 0
6 6 6 6 6 6 6 6 6 6
6 6 6 6 6 6 6 6 6 6
6 6 6 6 6 6 6 6 6 6
6 6 6 6 6 6 6 6 6 6
6 6 6 6 6 6 6 6 6 6
0 0 0 0 0 0 2 0 0 0
3 0 2 0 0 0 2 0 0 0
0 0 0 0 0 0 2 0 0 0
0 0 0 0 0 0 5 0 5 0
0 0 0 1 0 0 0 0 0 0
0 0 0 2 0 0 0 0 0 0
0 5 0 0 0 0 0 0 0 0
0 3 0 0 0 0 0 0 0 0
0 0 0 3 0 0 0 0 0 0
0 1 0 0 0 0 0 0 0 0
6 6 6 6 6 6 6 6 6 6
6 6 6 6 6 6 6 6 6 6
6 6 6 6 6 6 6 6 6 6
6 6 6 6 6 6 6 6 6 6
6 6 6 6 6 6 6 6 6 6
0 0 0 0 0 0 0 0 0 3
0 5 0 0 0 0 0 0 0 0
0 0 0 0 0 0 0 4 2 0
0 0 0 0 0 0 0 0 0 0
0 0 0 3 0 0 0 0 0 0
0 0 0 0 0 0 0 4 0 0
0 1 0 0 2 0 0 0 0 0
6 6 6 6 6 6 6 6 6 6
6 6 6 6 6 6 6 6 6 6
6 6 6 6 6 6 6 6 6 6
6 6 6 6 6 6 6 6 6 6
6 6 6 6 6 6 6 6 6 6
0 3 0 0 4 0 2 2 0 2
0 0 0 0 0 0 2 0 0 0
0 0 0 3 0 3 2 0 0 4
0 0 0 0 0 0 0 0 5 0
0 0 0 1 0 0 0 0 0 0
0 0 0 0 0 4 0 0 0 0
0 0 0 5 0 0 0 0 0 0
0 0 0 0 0 0 0 0 0 0
0 0 0 0 0 0 0 0 0 0
0 1 0 0 0 0 0 0 0 0
6 6 6 6 6 6 6 6 6 6
6 6 6 6 6 6 6 6 6 6
6 6 6 6 6 6 6 6 6 6
6 6 6 6 6 6 6 6 6 6
6 6 6 6 6 6 6 6 6 6
0 0 0 0 0 0 0 0 0 0
5 0 0 0 0 0 0 0 0 5
0 0 0 0 0 0 0 0 0 0
0 3 0 0 0 5 0 5 0 0
0 0 0 3 0 0 0 0 0 0
0 0 0 0 0 0 0 4 0 0
0 1 0 0 0 4 0 0 0 0
6 6 6 6 6 6 6 6 6 6
6 6 6 6 6 6 6 6 6 6
6 6 6 6 6 6 6 6 6 6
6 6 6 6 6 6 6 6 6 6
6 6 6 6 6 6 6 6 6 6
0 0 0 0 4 0 2 0 4 0
0 0 0 0 0 0 2 0 0 0
0 0 0 0 0 0 2 0 0 0
0 0 0 3 0 0 0 0 5 0
0 0 3 1 0 0 0 0 0 0
0 0 0 5 0 0 0 0 0 0
0 0 0 0 0 0 0 2 0 3
0 0 0 0 0 0 0 0 0 0
0 0 0 0 0 0 0 2 0 0
0 1 0 0 0 0 0 0 0 0
6 6 6 6 6 6 6 6 6 6
6 6 6 6 6 6 6 6 6 6
6 6 6 6 6 6 6 6 6 6
6 6 6 6 6 6 6 6 6 6
6 6 6 6 6 6 6 6 6 6
0 3 0 0 0 0 0 0 0 3
0 4 0 0 0 0 0 0 0 0
0 0 0 0 0 3 0 0 0 0
0 0 0 0 0 0 0 0 0 0
0 0 0 3 0 0 0 0 0 0
0 0 3 0 0 0 0 4 0 0
4 1 0 0 0 0 0 0 2 0
6 6 6 6 6 6 6 6 6 6
6 6 6 6 6 6 6 6 6 6
6 6 6 6 6 6 6 6 6 6
6 6 6 6 6 6 6 6 6 6
6 6 6 6 6 6 6 6 6 6
0 0 0 0 0 0 2 0 0 0
0 0 0 0 0 0 2 0 0 0
0 2 0 0 0 0 2 0 0 0
0 0 0 0 4 0 0 0 5 0
0 0 0 1 0 5 0 0 0 0
0 0 0 4 0 0 0 0 0 0
0 0 0 3 0 0 0 3 0 5
0 0 0 0 0 0 0 5 0 0
0 0 0 0 0 0 0 0 0 0
0 1 0 0 0 0 0 0 0 0
6 6 6 6 6 6 6 6 6 6
6 6 6 6 6 6 6 6 6 6
6 6 6 6 6 6 6 6 6 6
6 6 6 6 6 6 6 6 6 6
6 6 6 6 6 6 6 6 6 6
0 0 0 0 0 0 0 0 0 0
0 0 0 0 0 0 0 0 0 0
0 0 0 0 0 0 4 0 0 0
0 0 0 0 0 0 0 0 0 0
3 0 4 3 0 0 0 0 0 5
0 2 0 0 0 0 0 4 0 0
0 1 0 0 0 4 0 0 0 0
6 6 6 6 6 6 6 6 6 6
6 6 6 6 6 6 6 6 6 6
6 6 6 6 6 6 6 6 6 6
6 6 6 6 6 6 6 6 6 6
6 6 6 6 6 6 6 6 6 6
0 5 0 5 0 0 2 0 0 0
0 0 0 4 0 0 2 0 0 0
0 0 0 0 0 0 2 0 0 0
0 0 0 0 0 0 0 0 5 0
0 0 0 1 0 4 0 0 0 0
0 0 0 0 0 0 0 0 0 0
0 0 0 0 0 0 0 0 0 0
0 0 0 0 0 0 0 0 0 0
0 3 0 0 0 0 0 0 0 0
0 1 0 0 0 0 0 0 0 0
6 6 6 6 6 6 6 6 6 6
6 6 6 6 6 6 6 6 6 6
6 6 6 6 6 6 6 6 6 6
6 6 6 6 6 6 6 6 6 6
6 6 6 6 6 6 6 6 6 6
0 0 0 0 0 0 0 0 0 0
0 0 0 0 0 0 0 0 0 0
0 0 5 0 0 0 4 0 0 0
0 0 0 0 0 0 0 0 0 5
0 0 0 3 0 0 0 4 0 0
0 0 0 4 0 0 0 4 0 0
0 1 0 0 0 0 0 0 0 0
6 6 6 6 6 6 6 6 6 6
6 6 6 6 6 6 6 6 6 6
6 6 6 6 6 6 6 6 6 6
6 6 6 6 6 6 6 6 6 6
6 6 6 6 6 6 6 6 6 6
0 0 0 0 0 0 2 0 0 0
0 2 0 0 0 0 2 0 0 0
0 0 0 0 0 0 2 0 0 0
0 0 0 0 0 0 0 0 5 0
2 0 0 1 3 0 0 0 0 0
0 0 0 0 0 0 0 0 0 0
0 0 0 0 0 0 0 5 0 0
5 0 0 0 0 0 0 0 0 0
0 0 0 0 0 0 0 0 0 2
0 1 0 0 0 0 0 0 0 0
6 6 6 6 6 6 6 6 6 6
6 6 6 6 6 6 6 6 6 6
6 6 6 6 6 6 6 6 6 6
6 6 6 6 6 6 6 6 6 6
6 6 6 6 6 6 6 6 6 6
0 0 0 0 0 0 0 0 0 0
0 0 0 0 0 0 0 0 0 0
0 0 4 0 0 0 0 0 0 0
0 0 0 0 0 0 0 0 0 5
0 0 0 3 0 0 0 0 0 0
0 0 0 0 0 0 2 4 0 0
2 1 0 0 0 0 0 0 0 0
6 6 6 6 6 6 6 6 6 6
6 6 6 6 6 6 6 6 6 6
6 6 6 6 6 6 6 6 6 6
6 6 6 6 6 6 6 6 6 6
6 6 6 6 6 6 6 6 6 6
0 0 0 0 0 0 2 0 0 0
0 0 0 0 0 0 2 0 0 0
0 0 0 5 0 0 2 0 0 0
0 0 0 0 0 0 0 0 5 0
0 0 0 1 0 0 0 0 0 0